W,W,W,W,W,W,W,W,W,W,W,W
W,_,W,_,_,_,W,_,W,_,_,W
W,_,W,_,_,_,W,_,W,_,_,W
W,_,W,_,_,_,_,_,W,_,_,W
W,_,W,_,_,W,W,_,W,_,_,W
W,_,W,_,_,_,W,_,W,_,_,W
W,_,W,W,W,_,W,_,W,_,_,W
W,_,_,_,_,_,_,_,W,_,_,W
W,W,W,W,W,W,W,W,W,W,W,W
W,W,S(D),_,_,_,_,_,_,_,_,W
W,L,D(L),_,_,_,_,_,_,_,_,W
W,W,W,W,W,W,W,W,W,W,W,W