W,W,W,W,W,W,W,W,W,W,W,W,,,,
W,_,W,_,_,_,W,#,W,_,_,W,,,,
W,_,W,_,_,_,W,_,W,_,_,W,,,,
W,_,W,_,_,_,_,_,W,R,_,W,,,,
W,_,W,_,_,W,W,_,W,_,_,W,,,,
W,_,W,_,_,_,W,_,W,_,_,W,,,,
W,_,W,W,W,R,W,_,W,_,_,W,,,,
W,_,_,_,_,_,_,_,W,_,_,W,,,,
W,W,W,W,D,W,W,W,W,W,W,W,,,,
W,_,S(D),_,_,_,_,_,_,_,_,W,,,,
W,L,D,_,_,_,_,_,#,_,_,W,,,,
W,W,W,W,W,W,W,W,W,W,W,W,,,,
,,,,,,,,,,,,,,,
,,,,,,,,,,,,,,,
,,,,,,,,,,,,,,,
,,,,,,,,,,,,,,,